11111111
10010E01
1001C101
11000P01
1110C011
1C0C0001
1P011C01
11111111
