11111111
10010E01
101C101
11000001
1110C011
1C0C0001
1P011C01
11111111
