11111111
10010E01
10010101
11000001
11100011
10000001
1P011001
11111111
