11111111
1E010E01
1001C101
11000001
1110C011
1C0C0001
1P011C01
11111111
