1111111111
1C000000E1
1001100001
10000M0001
1010001111
100C0010C1
1C00000001
1010011001
1P10C0M001
1111111111
